SO brick.xpm   
NO brick.xpm
EA stone.xpm
WE stone.xpm 

F 255  ,   255  ,255
C 70,70,120


1111111111111111111111111             
10000000000000011100000111111111111         1111111111111111
10000000000000000000000000000000001         1000000010000001    
10000000000000000000000011111111101         1000000010000001
111111111111111111111111111111111011111111111000000010000001
                                1N00000000000000000011110111      11111111111
111111111111111111111111111111111011111111111000000000000001      10000000011
11110000000000000000000000000000001         1000000000000001      10000000001
11111111111111111111111111111111111         1111111111111111      11111111111
